10 18 1
0 7 7 8 7 9 2 3 6 6 0 1 6 8 7 9 3 0
0 8 0 1 1 7 6 5 9 0 0 9 7 9 8 2 1 2
1 0 2 0 2 1 0 3 2 1 7 8 6 6 7 2 1 6
4 0 1 6 6 8 1 2 2 1 8 6 7 6 8 2 1 8
6 3 1 7 4 2 1 0 7 2 2 1 0 1 2 3 2 0
7 4 0 4 1 2 7 8 9 1 6 7 6 8 7 6 6 8
5 1 1 0 0 8 8 9 7 2 2 3 6 8 8 7 7 8
3 0 6 0 1 7 7 7 1 1 3 4 2 1 1 0 2 7
1 0 8 6 1 0 1 1 2 7 7 3 3 8 7 1 1 6
0 7 7 8 0 2 8 9 8 6 8 6 7 6 9 6 0 0
地道战地图
那叫一个地道！